

{
    "towerPlacementData" :
    [0, 0, 0, 0, 0, 0, 0, 0, 0, 0, 0, 0, 0, 0, 0, 0, 0, 0, 0, 0, 0, 0, 0, 0, 0, 0, 0, 0, 0, 0, 0, 0, 0, 0, 0, 0, 0, 0, 0, 0,
        0, 0, 0, 0, 0, 0, 0, 0, 0, 0, 0, 0, 0, 0, 0, 0, 0, 0, 0, 0, 0, 0, 0, 0, 0, 0, 0, 0, 0, 0, 0, 0, 0, 0, 0, 0, 0, 0, 0, 0,
        0, 0, 0, 0, 0, 0, 0, 0, 0, 0, 0, 0, 0, 0, 0, 0, 0, 0, 0, 0, 0, 0, 0, 0, 0, 0, 0, 0, 0, 0, 0, 0, 0, 0, 0, 0, 0, 0, 0, 0,
        0, 0, 2035, 0, 2035, 0, 0, 0, 0, 2035, 0, 2035, 0, 2035, 0, 2035, 0, 2035, 0, 2035, 0, 2035, 0, 0, 2035, 0, 0, 0, 2035, 0, 2035, 0, 2035, 0, 0, 0, 0, 0, 0, 0,
        0, 0, 2035, 0, 2035, 0, 0, 0, 0, 2035, 0, 2035, 0, 2035, 0, 2035, 0, 2035, 0, 2035, 0, 2035, 0, 0, 2035, 0, 0, 0, 2035, 0, 2035, 0, 2035, 0, 0, 0, 0, 0, 0, 0,
        0, 0, 0, 0, 0, 0, 0, 0, 0, 0, 0, 0, 0, 0, 0, 0, 0, 2035, 0, 0, 0, 0, 0, 0, 0, 0, 0, 0, 0, 0, 0, 0, 0, 0, 0, 0, 0, 0, 0, 0,
        0, 0, 0, 0, 0, 0, 0, 0, 0, 0, 0, 0, 0, 0, 0, 0, 0, 2035, 0, 0, 0, 0, 0, 0, 0, 0, 0, 0, 0, 0, 0, 0, 0, 0, 0, 0, 0, 0, 0, 0,
        0, 0, 0, 0, 0, 0, 0, 0, 0, 0, 0, 0, 0, 0, 0, 0, 0, 2035, 0, 0, 0, 0, 0, 0, 0, 0, 0, 0, 0, 0, 0, 0, 0, 0, 0, 0, 0, 0, 0, 0,
        0, 0, 0, 0, 0, 0, 0, 0, 0, 0, 0, 0, 0, 0, 0, 0, 0, 2035, 0, 0, 0, 0, 0, 0, 0, 0, 0, 0, 0, 0, 0, 0, 0, 0, 0, 0, 0, 0, 0, 0,
        2035, 0, 0, 2035, 0, 2035, 0, 0, 0, 2035, 0, 2035, 0, 2035, 0, 0, 0, 2035, 0, 0, 2035, 0, 2035, 0, 2035, 0, 0, 0, 2035, 0, 2035, 0, 2035, 2035, 0, 2035, 0, 0, 0, 0,
        2035, 0, 0, 2035, 0, 2035, 0, 0, 0, 2035, 0, 2035, 0, 2035, 0, 0, 0, 2035, 0, 0, 0, 0, 2035, 0, 2035, 0, 0, 0, 2035, 0, 2035, 0, 2035, 2035, 0, 2035, 0, 0, 0, 0,
        2035, 0, 0, 0, 0, 0, 0, 0, 0, 0, 0, 0, 0, 0, 0, 0, 0, 2035, 0, 0, 0, 0, 0, 0, 0, 0, 0, 0, 0, 0, 0, 0, 0, 2035, 0, 2035, 0, 0, 0, 0,
        2035, 0, 0, 0, 0, 0, 0, 0, 0, 0, 0, 0, 0, 0, 0, 0, 0, 2035, 0, 0, 2035, 0, 0, 0, 0, 0, 0, 0, 0, 0, 0, 0, 0, 2035, 0, 2035, 0, 0, 0, 0,
        2035, 0, 0, 0, 2035, 0, 0, 2035, 0, 0, 2035, 0, 0, 0, 0, 0, 0, 2035, 0, 0, 2035, 0, 0, 0, 0, 0, 0, 0, 0, 0, 0, 0, 0, 2035, 0, 2035, 0, 0, 0, 0,
        2035, 0, 0, 0, 2035, 0, 0, 2035, 0, 0, 2035, 0, 0, 0, 0, 0, 0, 0, 0, 0, 2035, 0, 0, 0, 2035, 0, 2035, 0, 2035, 0, 2035, 0, 0, 0, 0, 0, 0, 0, 0, 0,
        2035, 0, 0, 0, 2035, 0, 0, 2035, 0, 0, 2035, 0, 0, 0, 0, 0, 0, 0, 0, 0, 2035, 0, 0, 0, 2035, 0, 2035, 0, 2035, 0, 2035, 0, 0, 0, 0, 0, 0, 0, 0, 0,
        0, 0, 0, 0, 2035, 0, 0, 2035, 0, 0, 2035, 0, 0, 0, 0, 0, 0, 0, 0, 0, 2035, 0, 0, 0, 0, 0, 0, 0, 0, 0, 0, 0, 0, 2035, 0, 2035, 0, 0, 0, 0,
        0, 0, 0, 0, 2035, 0, 0, 2035, 0, 0, 2035, 0, 0, 0, 0, 0, 0, 0, 0, 0, 0, 0, 0, 0, 0, 0, 0, 0, 0, 0, 0, 0, 0, 2035, 0, 2035, 0, 0, 0, 0,
        0, 0, 0, 0, 0, 0, 0, 0, 0, 0, 2035, 0, 0, 0, 0, 0, 0, 0, 0, 0, 0, 0, 0, 0, 0, 0, 0, 0, 0, 0, 0, 0, 0, 2035, 0, 2035, 0, 0, 0, 0,
        0, 0, 0, 0, 0, 0, 0, 0, 0, 0, 2035, 0, 0, 0, 0, 0, 0, 0, 0, 0, 0, 0, 0, 0, 0, 0, 0, 0, 0, 0, 0, 0, 0, 2035, 0, 2035, 0, 0, 0, 0,
        0, 0, 0, 0, 0, 0, 0, 0, 0, 0, 2035, 0, 2035, 0, 2035, 0, 2035, 0, 2035, 0, 2035, 0, 2035, 0, 2035, 0, 0, 2035, 0, 2035, 0, 2035, 0, 0, 0, 0, 0, 0, 0, 0,
        0, 0, 0, 0, 0, 0, 0, 0, 0, 0, 0, 0, 0, 0, 0, 0, 0, 0, 0, 0, 0, 0, 0, 0, 0, 0, 0, 2035, 0, 2035, 0, 2035, 0, 0, 0, 0, 0, 0, 0, 0,
        0, 0, 0, 0, 0, 0, 0, 0, 0, 0, 0, 0, 0, 0, 0, 0, 0, 0, 0, 0, 0, 0, 0, 0, 0, 0, 0, 0, 0, 0, 0, 0, 0, 0, 0, 0, 0, 0, 0, 0,
        0, 0, 0, 0, 0, 0, 0, 0, 0, 0, 0, 0, 0, 0, 0, 0, 0, 0, 0, 0, 0, 0, 0, 0, 0, 0, 0, 0, 0, 0, 0, 0, 0, 0, 0, 0, 0, 0, 0, 0
    ],

    "enemyPathA": [
        {
            "x": 1372,
            "y": 461
        },
        {
            "x": 1038,
            "y": 460
        },
        {
            "x": 1036,
            "y": 363
        },
        {
            "x": 859,
            "y": 362
        },
        {
            "x": 858,
            "y": 46
        },
        {
            "x": 252,
            "y": 44
        },
        {
            "x": 249,
            "y": 324
        },
        {
            "x": 227,
            "y": 376
        },
        {
            "x": 78,
            "y": 378
        },
        {
            "x": 78,
            "y": 573
        }
    ],
    
    "enemyPathB": [
        {
            "x": 1365.33333333333,
            "y": 461.333333333333
        },
        {
            "x": 1036,
            "y": 458.666666666667
        },
        {
            "x": 1036,
            "y": 589.333333333333
        },
        {
            "x": 708,
            "y": 592
        },
        {
            "x": 629.333333333333,
            "y": 572
        },
        {
            "x": 426.666666666667,
            "y": 572
        },
        {
            "x": 425.333333333333,
            "y": 380
        },
        {
            "x": 82.6666666666667,
            "y": 381.333333333333
        },
        {
            "x": 82.6666666666667,
            "y": 577.333333333333
        }
    ],

    "enemyPathC": [
        {
            "x": 1368,
            "y": 462
        },
        {
            "x": 1037,
            "y": 457
        },
        {
            "x": 1037,
            "y": 362
        },
        {
            "x": 711,
            "y": 363
        },
        {
            "x": 712,
            "y": 569
        },
        {
            "x": 428,
            "y": 570
        },
        {
            "x": 428,
            "y": 377
        },
        {
            "x": 75,
            "y": 377
        },
        {
            "x": 76,
            "y": 577
        }
    ]
}